################
#o      ###    #
# ######### ## #
# #   #   # ## #
# # # # # # #  #
# # # # # # # ##
# # # # # # # ##
# # # # # # # ##
# # # # # # # ##
# # # # # # # ##
#   #   #   # x#
################
